#List of verbose phrases. Such as repetition, verbosity, and clumsy phrases.
#قائمة عبارات الإسهاب المفرط. مثل التكرار والإطناب والعبارات الركيكة.
هناك خطأ في العبارة=في العبارة خطأ
هناك مشكلة في الكمبيوتر=في الحاسوب مشكلة
هناك سيارة في الطريق=في الطريق سيارة
الأحسن من ذلك=أحسن من ذلك
الأحسن من هذا=أحسن من هذا
النتائج الأفضل=أفضل النتائج
ليكن في علم=نُعلم
نحيطكم علما=نُعلمكم
لي عظيم الشرف=يُشرفني
وأخيرا وليس آخرا=وأخيرا
لأول وهلة=أول وهلة
# تحويل المصدر إلى  مقارنةتحويل المصدر إلى  مقارنة
أكثر أحقية=أَحَقَّ 	 استعمال اسم التفضيل في الثلاثي أفضل من استعمال أكثر، تعبير مترجم من الإنجليزية more
أكثر إنصافا=أَنْصَف	 استعمال اسم التفضيل في الثلاثي أفضل من استعمال أكثر، تعبير مترجم من الإنجليزية more
أكثر أولوية=أوْلَى	 استعمال اسم التفضيل في الثلاثي أفضل من استعمال أكثر، تعبير مترجم من الإنجليزية more
أكثر بروزا=أَبْرَز	 استعمال اسم التفضيل في الثلاثي أفضل من استعمال أكثر، تعبير مترجم من الإنجليزية more
أكثر بساطة=أَبْسَط	 استعمال اسم التفضيل في الثلاثي أفضل من استعمال أكثر، تعبير مترجم من الإنجليزية more
أكثر بطئا=أَبْطَأَ	 استعمال اسم التفضيل في الثلاثي أفضل من استعمال أكثر، تعبير مترجم من الإنجليزية more
أكثر بعدا=أَبْعَد	 استعمال اسم التفضيل في الثلاثي أفضل من استعمال أكثر، تعبير مترجم من الإنجليزية more
أكثر بهاء=أَبْهَى	 استعمال اسم التفضيل في الثلاثي أفضل من استعمال أكثر، تعبير مترجم من الإنجليزية more
أكثر ثقة=أوْثَق	 استعمال اسم التفضيل في الثلاثي أفضل من استعمال أكثر، تعبير مترجم من الإنجليزية more
أكثر ثقلا=أَثْقَل	 استعمال اسم التفضيل في الثلاثي أفضل من استعمال أكثر، تعبير مترجم من الإنجليزية more
أكثر جدوى=أَجْدَى	 استعمال اسم التفضيل في الثلاثي أفضل من استعمال أكثر، تعبير مترجم من الإنجليزية more
أكثر جمالا=أَجْمَل	 استعمال اسم التفضيل في الثلاثي أفضل من استعمال أكثر، تعبير مترجم من الإنجليزية more
أكثر جودة=أَجْوَد	 استعمال اسم التفضيل في الثلاثي أفضل من استعمال أكثر، تعبير مترجم من الإنجليزية more
أكثر جودة=أَجْوَد	 استعمال اسم التفضيل في الثلاثي أفضل من استعمال أكثر، تعبير مترجم من الإنجليزية more
أكثر حرصا=أَحْرَص	 استعمال اسم التفضيل في الثلاثي أفضل من استعمال أكثر، تعبير مترجم من الإنجليزية more
أكثر حسنا=أَحْسَن	 استعمال اسم التفضيل في الثلاثي أفضل من استعمال أكثر، تعبير مترجم من الإنجليزية more
أكثر حكمة=أَحْكَم	 استعمال اسم التفضيل في الثلاثي أفضل من استعمال أكثر، تعبير مترجم من الإنجليزية more
أكثر حلاوة=أحْلَى	 استعمال اسم التفضيل في الثلاثي أفضل من استعمال أكثر، تعبير مترجم من الإنجليزية more
أكثر خسرانا=أَخْسَر	 استعمال اسم التفضيل في الثلاثي أفضل من استعمال أكثر، تعبير مترجم من الإنجليزية more
أكثر خصوصا=أَخَصَّ	 استعمال اسم التفضيل في الثلاثي أفضل من استعمال أكثر، تعبير مترجم من الإنجليزية more
أكثر خفاء=أَخْفَى	 استعمال اسم التفضيل في الثلاثي أفضل من استعمال أكثر، تعبير مترجم من الإنجليزية more
أكثر خفة=أخفَّ	 استعمال اسم التفضيل في الثلاثي أفضل من استعمال أكثر، تعبير مترجم من الإنجليزية more
أكثر خيرا=أخْيَر	 استعمال اسم التفضيل في الثلاثي أفضل من استعمال أكثر، تعبير مترجم من الإنجليزية more
أكثر دنوا=أَدْنَى	 استعمال اسم التفضيل في الثلاثي أفضل من استعمال أكثر، تعبير مترجم من الإنجليزية more
أكثر دهاء=أَدْهَى	 استعمال اسم التفضيل في الثلاثي أفضل من استعمال أكثر، تعبير مترجم من الإنجليزية more
أكثر ذكاء=أَذْكى	 استعمال اسم التفضيل في الثلاثي أفضل من استعمال أكثر، تعبير مترجم من الإنجليزية more
أكثر رجاحة=أَرْجَح	 استعمال اسم التفضيل في الثلاثي أفضل من استعمال أكثر، تعبير مترجم من الإنجليزية more
أكثر رداءة=أَرْدَأَ	 استعمال اسم التفضيل في الثلاثي أفضل من استعمال أكثر، تعبير مترجم من الإنجليزية more
أكثر رذالة=أَرْذَل	 استعمال اسم التفضيل في الثلاثي أفضل من استعمال أكثر، تعبير مترجم من الإنجليزية more
أكثر رقة=أَرَقَّ	 استعمال اسم التفضيل في الثلاثي أفضل من استعمال أكثر، تعبير مترجم من الإنجليزية more
أكثر روعة=أَرْوَع	 استعمال اسم التفضيل في الثلاثي أفضل من استعمال أكثر، تعبير مترجم من الإنجليزية more
أكثر زيادة=أَزْيَد	 استعمال اسم التفضيل في الثلاثي أفضل من استعمال أكثر، تعبير مترجم من الإنجليزية more
أكثر سبقا=أَسْبَق	 استعمال اسم التفضيل في الثلاثي أفضل من استعمال أكثر، تعبير مترجم من الإنجليزية more
أكثر سرعة=أَسْرَع	 استعمال اسم التفضيل في الثلاثي أفضل من استعمال أكثر، تعبير مترجم من الإنجليزية more
أكثر سفالة=أَسْفَل	 استعمال اسم التفضيل في الثلاثي أفضل من استعمال أكثر، تعبير مترجم من الإنجليزية more
أكثر سلاسة=أَسْلَس	 استعمال اسم التفضيل في الثلاثي أفضل من استعمال أكثر، تعبير مترجم من الإنجليزية more
أكثر سموا=أسْمَى	 استعمال اسم التفضيل في الثلاثي أفضل من استعمال أكثر، تعبير مترجم من الإنجليزية more
أكثر سهولة=أسهل	 استعمال اسم التفضيل في الثلاثي أفضل من استعمال أكثر، تعبير مترجم من الإنجليزية more
أكثر سوءا=أَسْوَأَ	 استعمال اسم التفضيل في الثلاثي أفضل من استعمال أكثر، تعبير مترجم من الإنجليزية more
أكثر شبها=أشْبَه	 استعمال اسم التفضيل في الثلاثي أفضل من استعمال أكثر، تعبير مترجم من الإنجليزية more
أكثر شجاعة=أَشْجَع	 استعمال اسم التفضيل في الثلاثي أفضل من استعمال أكثر، تعبير مترجم من الإنجليزية more
أكثر شدة=أَشَدَّ	 استعمال اسم التفضيل في الثلاثي أفضل من استعمال أكثر، تعبير مترجم من الإنجليزية more
أكثر شرفا=أَشْرَف	 استعمال اسم التفضيل في الثلاثي أفضل من استعمال أكثر، تعبير مترجم من الإنجليزية more
أكثر شقاء=أَشْقى	 استعمال اسم التفضيل في الثلاثي أفضل من استعمال أكثر، تعبير مترجم من الإنجليزية more
أكثر شهرة=أشْهَر	 استعمال اسم التفضيل في الثلاثي أفضل من استعمال أكثر، تعبير مترجم من الإنجليزية more
أكثر صدقا=أَصْدَق	 استعمال اسم التفضيل في الثلاثي أفضل من استعمال أكثر، تعبير مترجم من الإنجليزية more
أكثر صعوبة=أَصْعَب	 استعمال اسم التفضيل في الثلاثي أفضل من استعمال أكثر، تعبير مترجم من الإنجليزية more
أكثر صغرا=أَصْغَر	 استعمال اسم التفضيل في الثلاثي أفضل من استعمال أكثر، تعبير مترجم من الإنجليزية more
أكثر صلاحا=أَصْلَح	 استعمال اسم التفضيل في الثلاثي أفضل من استعمال أكثر، تعبير مترجم من الإنجليزية more
أكثر ضخامة=أَضْخَم	 استعمال اسم التفضيل في الثلاثي أفضل من استعمال أكثر، تعبير مترجم من الإنجليزية more
أكثر ضيقا=أَضْيَق	 استعمال اسم التفضيل في الثلاثي أفضل من استعمال أكثر، تعبير مترجم من الإنجليزية more
أكثر طولا=أَطْوَل	 استعمال اسم التفضيل في الثلاثي أفضل من استعمال أكثر، تعبير مترجم من الإنجليزية more
أكثر طيبة=أَطْيَب	 استعمال اسم التفضيل في الثلاثي أفضل من استعمال أكثر، تعبير مترجم من الإنجليزية more
أكثر ظرفا=أَظْرَف	 استعمال اسم التفضيل في الثلاثي أفضل من استعمال أكثر، تعبير مترجم من الإنجليزية more
أكثر ظهورا=أَظْهَر	 استعمال اسم التفضيل في الثلاثي أفضل من استعمال أكثر، تعبير مترجم من الإنجليزية more
أكثر عراقة=أعْرَق	 استعمال اسم التفضيل في الثلاثي أفضل من استعمال أكثر، تعبير مترجم من الإنجليزية more
أكثر عزة=أعَزَّ	 استعمال اسم التفضيل في الثلاثي أفضل من استعمال أكثر، تعبير مترجم من الإنجليزية more
أكثر عسرا=أَعْسَر	 استعمال اسم التفضيل في الثلاثي أفضل من استعمال أكثر، تعبير مترجم من الإنجليزية more
أكثر عظما=أعْظَم	 استعمال اسم التفضيل في الثلاثي أفضل من استعمال أكثر، تعبير مترجم من الإنجليزية more
أكثر علما=أعْلَم	 استعمال اسم التفضيل في الثلاثي أفضل من استعمال أكثر، تعبير مترجم من الإنجليزية more
أكثر علوا=أعْلَى	 استعمال اسم التفضيل في الثلاثي أفضل من استعمال أكثر، تعبير مترجم من الإنجليزية more
أكثر عموما=أَعَمَّ	 استعمال اسم التفضيل في الثلاثي أفضل من استعمال أكثر، تعبير مترجم من الإنجليزية more
أكثر عنفا=أعْنَف	 استعمال اسم التفضيل في الثلاثي أفضل من استعمال أكثر، تعبير مترجم من الإنجليزية more
أكثر غزارة=أَغْزَر	 استعمال اسم التفضيل في الثلاثي أفضل من استعمال أكثر، تعبير مترجم من الإنجليزية more
أكثر غلاء=أغْلَى	 استعمال اسم التفضيل في الثلاثي أفضل من استعمال أكثر، تعبير مترجم من الإنجليزية more
أكثر غلبة=أغْلَب	 استعمال اسم التفضيل في الثلاثي أفضل من استعمال أكثر، تعبير مترجم من الإنجليزية more
أكثر فخامة=أَفْخَم	 استعمال اسم التفضيل في الثلاثي أفضل من استعمال أكثر، تعبير مترجم من الإنجليزية more
أكثر فصاحة=أْفْصَح	 استعمال اسم التفضيل في الثلاثي أفضل من استعمال أكثر، تعبير مترجم من الإنجليزية more
أكثر فضلا=أفْضَل	 استعمال اسم التفضيل في الثلاثي أفضل من استعمال أكثر، تعبير مترجم من الإنجليزية more
أكثر قبحا=أقْبَح	 استعمال اسم التفضيل في الثلاثي أفضل من استعمال أكثر، تعبير مترجم من الإنجليزية more
أكثر قدرة=أقْدَر	 استعمال اسم التفضيل في الثلاثي أفضل من استعمال أكثر، تعبير مترجم من الإنجليزية more
أكثر قدما=أقْدَم	 استعمال اسم التفضيل في الثلاثي أفضل من استعمال أكثر، تعبير مترجم من الإنجليزية more
أكثر قراءة=أقْرأَ	 استعمال اسم التفضيل في الثلاثي أفضل من استعمال أكثر، تعبير مترجم من الإنجليزية more
أكثر قرابة=أقْرَب	 استعمال اسم التفضيل في الثلاثي أفضل من استعمال أكثر، تعبير مترجم من الإنجليزية more
أكثر قسوة=أقْسَى	 استعمال اسم التفضيل في الثلاثي أفضل من استعمال أكثر، تعبير مترجم من الإنجليزية more
أكثر قصرا=أقْصَر	 استعمال اسم التفضيل في الثلاثي أفضل من استعمال أكثر، تعبير مترجم من الإنجليزية more
أكثر قلة=أَقَلَّ	 استعمال اسم التفضيل في الثلاثي أفضل من استعمال أكثر، تعبير مترجم من الإنجليزية more
أكثر قوامة=أَقْوَم	 استعمال اسم التفضيل في الثلاثي أفضل من استعمال أكثر، تعبير مترجم من الإنجليزية more
أكثر قوة=أَقْوَى	 استعمال اسم التفضيل في الثلاثي أفضل من استعمال أكثر، تعبير مترجم من الإنجليزية more
أكثر كبرا=أكْبَر	 استعمال اسم التفضيل في الثلاثي أفضل من استعمال أكثر، تعبير مترجم من الإنجليزية more
أكثر كثرة=أَكْثَر	 استعمال اسم التفضيل في الثلاثي أفضل من استعمال أكثر، تعبير مترجم من الإنجليزية more
أكثر كرما=أكْرَم	 استعمال اسم التفضيل في الثلاثي أفضل من استعمال أكثر، تعبير مترجم من الإنجليزية more
أكثر كفاءة=أَكْفَأَ	 استعمال اسم التفضيل في الثلاثي أفضل من استعمال أكثر، تعبير مترجم من الإنجليزية more
أكثر كمالا=أَكْمَل	 استعمال اسم التفضيل في الثلاثي أفضل من استعمال أكثر، تعبير مترجم من الإنجليزية more
أكثر كياسة=أَكْيَس	 استعمال اسم التفضيل في الثلاثي أفضل من استعمال أكثر، تعبير مترجم من الإنجليزية more
أكثر لذة=ألَذَّ	 استعمال اسم التفضيل في الثلاثي أفضل من استعمال أكثر، تعبير مترجم من الإنجليزية more
أكثر لطفا=ألطف	 استعمال اسم التفضيل في الثلاثي أفضل من استعمال أكثر، تعبير مترجم من الإنجليزية more
أكثر لينا=ألْيَن	 استعمال اسم التفضيل في الثلاثي أفضل من استعمال أكثر، تعبير مترجم من الإنجليزية more
أكثر مجدا=أَمْجَد	 استعمال اسم التفضيل في الثلاثي أفضل من استعمال أكثر، تعبير مترجم من الإنجليزية more
أكثر مرارة=أَمَرَّ	 استعمال اسم التفضيل في الثلاثي أفضل من استعمال أكثر، تعبير مترجم من الإنجليزية more
أكثر مضاء=أَمْضى	 استعمال اسم التفضيل في الثلاثي أفضل من استعمال أكثر، تعبير مترجم من الإنجليزية more
أكثر معرفة=أعْرَف	 استعمال اسم التفضيل في الثلاثي أفضل من استعمال أكثر، تعبير مترجم من الإنجليزية more
أكثر ملاحة=أَمْلَح	 استعمال اسم التفضيل في الثلاثي أفضل من استعمال أكثر، تعبير مترجم من الإنجليزية more
أكثر ميولا=أَمْيَل	 استعمال اسم التفضيل في الثلاثي أفضل من استعمال أكثر، تعبير مترجم من الإنجليزية more
أكثر نبلا=أَنْبَل	 استعمال اسم التفضيل في الثلاثي أفضل من استعمال أكثر، تعبير مترجم من الإنجليزية more
أكثر نجاعة=أَنْجَع	 استعمال اسم التفضيل في الثلاثي أفضل من استعمال أكثر، تعبير مترجم من الإنجليزية more
أكثر ندية=أَنْدَى	 استعمال اسم التفضيل في الثلاثي أفضل من استعمال أكثر، تعبير مترجم من الإنجليزية more
أكثر نسبة=أَنْسَب	 استعمال اسم التفضيل في الثلاثي أفضل من استعمال أكثر، تعبير مترجم من الإنجليزية more
أكثر نفعا=أَنْفَع	 استعمال اسم التفضيل في الثلاثي أفضل من استعمال أكثر، تعبير مترجم من الإنجليزية more
أكثر نقاء=أَنْقَى	 استعمال اسم التفضيل في الثلاثي أفضل من استعمال أكثر، تعبير مترجم من الإنجليزية more
أكثر نورا=أَنْوَر	 استعمال اسم التفضيل في الثلاثي أفضل من استعمال أكثر، تعبير مترجم من الإنجليزية more
أكثر هلاكا=أهْلَك	 استعمال اسم التفضيل في الثلاثي أفضل من استعمال أكثر، تعبير مترجم من الإنجليزية more
أكثر هونا=أهْوَن	 استعمال اسم التفضيل في الثلاثي أفضل من استعمال أكثر، تعبير مترجم من الإنجليزية more
أكثر وجاهة=أوْجَه	 استعمال اسم التفضيل في الثلاثي أفضل من استعمال أكثر، تعبير مترجم من الإنجليزية more
أكثر وزنا=أوْزَن	 استعمال اسم التفضيل في الثلاثي أفضل من استعمال أكثر، تعبير مترجم من الإنجليزية more
أكثر وسامة=أوْسَم	 استعمال اسم التفضيل في الثلاثي أفضل من استعمال أكثر، تعبير مترجم من الإنجليزية more
أكثر وسطية=أوْسَط	 استعمال اسم التفضيل في الثلاثي أفضل من استعمال أكثر، تعبير مترجم من الإنجليزية more
أكثر وسع، اتساعا=أوْسَع	 استعمال اسم التفضيل في الثلاثي أفضل من استعمال أكثر، تعبير مترجم من الإنجليزية more
أكثر وضوحا=أوْضَح	 استعمال اسم التفضيل في الثلاثي أفضل من استعمال أكثر، تعبير مترجم من الإنجليزية more
أكثر وعورة=أوْعَر	 استعمال اسم التفضيل في الثلاثي أفضل من استعمال أكثر، تعبير مترجم من الإنجليزية more
أكثر وعيا=أَوْعَى	 استعمال اسم التفضيل في الثلاثي أفضل من استعمال أكثر، تعبير مترجم من الإنجليزية more
أكثر وفرة=أَوْفَر	 استعمال اسم التفضيل في الثلاثي أفضل من استعمال أكثر، تعبير مترجم من الإنجليزية more
أكثر وهيا=أوْهَى	 استعمال اسم التفضيل في الثلاثي أفضل من استعمال أكثر، تعبير مترجم من الإنجليزية more
أكثر يسرا=أَيْسَر	 استعمال اسم التفضيل في الثلاثي أفضل من استعمال أكثر، تعبير مترجم من الإنجليزية more
أكثر يمنا=أَيْمَن	 استعمال اسم التفضيل في الثلاثي أفضل من استعمال أكثر، تعبير مترجم من الإنجليزية more
أكثر سخونة=أسخن	 استعمال اسم التفضيل في الثلاثي أفضل من استعمال أكثر، تعبير مترجم من الإنجليزية more
أكثر برودة=أبرد	 استعمال اسم التفضيل في الثلاثي أفضل من استعمال أكثر، تعبير مترجم من الإنجليزية more

